SR30001	0
SR30001	1
SR30001	2
SR30001	9
SR30001	0
SR30001	9
SR30001	0
SR30002	1
SR30002	2
SR30002	3
SR30002	1
SR30002	1
SR30010	fdzgfg
SR30010	gdzg
SR30010	zgfdg
SR30010	gfdzg
SR30010	ffd
SR30003	2
SR30003	3
SR30003	4
SR30003	2
SR30003	2
SR30004	3
SR30004	3
SR30004	3
SR30005	4
SR30005	4
SR30005	4
SR30006	5
SR30006	5
SR30006	5
SR30007	6
SR30007	6
SR30008	7
SR30008	7
SR30009	8
SR30009	8
